Je	PRO:PER	je
m’	PRO	me !!
acolyte	VER:pres	acolyter !!
trop	ADV	trop
avec	PRP	avec
moi	PRO	moi
-même	PRO	même !!
.	SENT	.
Je	PRO:PER	je
me	PRO:PER	me
colle	VER:pres	coller
au	PRP:det	au
pare-brise	NOM	pare-brise
ça	PRO:DEM	cela
me	PRO:PER	me
gêne	VER:pres	gêner
.	SENT	.
Ça	PRO:DEM	cela
sent	VER:pres	sentir
le	PRO:PER	le
cramé	NOM	cramé !!
sous	PRP	sous
les	DET:ART	le
projos	NOM	projo
.	SENT	.
Regarde	VER:impe	regarder
où	ADV	où
j’	PRO	je !! 
en	PRO	en !!
suis	VER:pres	suivre|être
je	PRO:PER	je
tringle	VER:pres	tringler
aux	PRP:det	au
rideaux	NOM	rideau
.	SENT	.
C’	PRO:DEM	ce !!
est	VER	être !!
comment	ADV	comment
qu’	KON	que !!
on	PRO	on !!
freine	VER:pres	freiner
.	SENT	.
Je	PRO:PER	je
voudrais	VER:cond	vouloir
descendre	VER:infi	descendre
de	PRP	de
là	ADV	là
.	SENT	.